80 80
100 100
2 2 2 2 2 2 2 2 2 2 2 2 2 2 2 2 2 2 2 2 2 2 2 2 2 2 2 2 2 2 2 2 2 2 2 2 2 2 2 2 2 2 2 2 2 2 2 2 2 2 2 2 2 2 2 2 2 2 2 2 2 2 2 2 2 2 2 2 2 2 2 2 2 2 2 2 2 2 2 2
2 3 3 3 3 4 3 3 3 3 3 3 3 3 3 3 3 3 3 3 3 3 3 3 3 3 3 3 3 3 3 3 3 3 3 3 3 3 3 3 3 3 3 3 3 3 3 3 3 3 3 3 3 3 3 3 3 3 3 3 3 3 3 3 3 3 3 3 3 3 3 3 3 3 3 3 3 4 3 3
2 7 7 7 7 5 7 7 7 7 7 7 7 7 7 7 7 7 7 7 7 7 7 7 7 7 7 7 7 7 7 7 7 7 7 7 7 7 7 7 7 7 7 7 7 7 7 7 7 7 7 7 7 7 7 7 7 7 7 7 7 7 7 7 7 7 7 7 7 7 7 7 7 7 7 7 7 5 7 7
2 7 7 7 7 5 7 7 7 7 7 7 7 7 7 7 7 7 7 7 7 7 7 7 7 7 7 7 7 7 7 7 7 7 7 7 7 7 7 7 7 7 7 7 7 7 7 7 7 7 7 7 7 7 7 7 7 7 7 7 7 7 7 7 7 7 7 7 7 7 7 7 7 7 7 7 7 5 7 7
2 7 7 7 7 5 7 7 7 7 7 7 7 7 7 7 7 7 7 7 7 7 7 7 7 7 7 7 7 7 7 7 7 7 7 7 7 7 7 7 7 7 7 7 7 7 7 7 7 7 7 7 7 7 7 7 7 7 7 7 7 7 7 7 7 7 7 7 7 7 7 7 7 7 7 7 7 5 7 7
2 8 8 8 8 6 8 8 8 8 8 8 8 8 8 8 8 8 8 8 8 8 8 8 8 8 8 8 8 8 8 8 8 8 8 8 8 8 8 8 8 8 8 8 8 8 8 8 8 8 8 8 8 8 8 8 8 8 8 8 8 8 8 8 8 8 8 8 8 8 8 8 8 8 8 8 8 6 8 8 
2 2 2 2 2 2 2 2 2 2 2 2 2 2 2 2 2 2 2 2 2 2 2 2 2 2 2 2 2 2 2 2 2 2 2 2 2 2 2 2 2 2 2 2 2 2 2 2 2 2 2 2 2 2 2 2 2 2 2 2 2 2 2 2 2 2 2 2 2 2 2 2 2 2 2 2 2 2 2 2
1 2 1 1 1 1 1 1 1 1 1 1 1 1 1 1 1 1 1 1 1 1 1 1 1 2 2 2 2 2 2 1 1 2 2 1 1 1 1 2 2 1 1 1 1 2 2 2 1 1 1 2 2 2 2 1 1 1 1 2 2 1 1 1 1 2 2 2 2 1 1 2 2 2 2 1 1 1 1 2
2 11 7 7 7 1 1 1 1 1 1 1 1 1 1 1 1 1 1 1 2 11 7 7 9 2 2 2 2 2 2 2 2 2 2 11 7 7 9 2 2 11 7 7 9 2 2 2 2 2 2 2 2 2 2 11 7 7 9 2 2 11 7 7 9 2 2 2 2 2 2 2 2 2 2 11 7 7 9 2
2 11 7 7 9 2 2 2 2 11 7 7 7 2 2 11 7 7 9 11 2 11 7 7 9 2 2 2 2 2 2 2 2 2 2 11 7 7 9 2 2 11 7 7 9 2 2 2 2 2 2 2 2 2 2 11 7 7 9 2 2 11 7 7 9 2 2 2 2 2 2 2 2 2 2 11 7 7 9 2
2 11 7 7 9 2 2 2 2 11 2 2 2 2 2 11 7 7 9 11 2 11 7 7 9 2 2 2 2 2 2 2 2 2 2 11 7 7 9 2 2 11 7 7 9 2 2 2 2 2 2 2 2 2 2 11 7 7 9 2 2 11 7 7 9 2 2 2 2 2 2 2 2 2 2 11 7 7 9 2
2 11 7 7 9 2 2 2 2 11 2 2 2 2 2 11 7 7 9 2 2 11 7 7 9 2 2 2 2 2 2 2 2 2 2 11 7 7 9 2 2 11 7 7 9 2 2 2 2 2 2 2 2 2 2 11 7 7 9 2 2 11 7 7 9 2 2 2 2 2 2 2 2 2 2 11 7 7 9 2
2 11 7 7 9 2 2 2 2 2 2 2 2 2 2 11 7 7 9 2 2 11 7 7 9 2 2 2 2 2 2 2 2 2 2 11 7 7 9 2 2 11 7 7 9 2 2 2 2 2 2 2 2 2 2 11 7 7 9 2 2 11 7 7 9 2 2 2 2 2 2 2 2 2 2 11 7 7 9 2
2 11 7 7 9 2 2 2 2 2 2 2 2 2 2 11 7 7 9 2 2 11 7 7 9 2 2 2 2 2 2 2 2 2 2 11 7 7 9 2 2 11 7 7 9 2 2 2 2 2 2 2 2 2 2 11 7 7 9 2 2 11 7 7 9 2 2 2 2 2 2 2 2 2 2 11 7 7 9 2
2 11 7 7 9 2 2 2 2 2 2 2 2 2 2 11 7 7 9 2 2 11 7 7 9 2 2 2 2 2 2 2 2 2 2 11 7 7 9 2 2 11 7 7 9 2 2 2 2 2 2 2 2 2 2 11 7 7 9 2 2 11 7 7 9 2 2 2 2 2 2 2 2 2 2 11 7 7 9 2
2 11 7 7 9 2 2 2 2 2 2 2 2 2 2 11 7 7 9 2 2 11 7 7 9 2 2 2 2 2 2 2 2 2 2 11 7 7 9 2 2 11 7 7 9 2 2 2 2 2 2 2 2 2 2 11 7 7 9 2 2 11 7 7 9 2 2 2 2 2 2 2 2 2 2 11 7 7 9 2
2 11 7 7 9 2 2 2 2 2 2 2 2 2 2 11 7 7 9 2 2 11 7 7 9 2 2 2 2 2 2 2 2 2 2 11 7 7 9 2 2 11 7 7 9 2 2 2 2 2 2 2 2 2 2 11 7 7 9 2 2 11 7 7 9 2 2 2 2 2 2 2 2 2 2 11 7 7 9 2
2 11 7 7 9 2 2 2 2 2 2 2 2 2 2 11 7 7 9 2 2 11 7 7 9 2 2 2 2 2 2 2 2 2 2 11 7 7 9 2 2 11 7 7 9 2 2 2 2 2 2 2 2 2 2 11 7 7 9 2 2 11 7 7 9 2 2 2 2 2 2 2 2 2 2 11 7 7 9 2
2 11 7 7 9 2 2 2 2 2 2 2 2 2 2 11 7 7 9 2 2 11 7 7 9 2 2 2 2 2 2 2 2 2 2 11 7 7 9 2 2 11 7 7 9 2 2 2 2 2 2 2 2 2 2 11 7 7 9 2 2 11 7 7 9 2 2 2 2 2 2 2 2 2 2 11 7 7 9 2
2 11 7 7 9 2 2 2 2 2 2 2 2 2 2 11 7 7 9 2 2 11 7 7 9 2 2 2 2 2 2 2 2 2 2 11 7 7 9 2 2 11 7 7 9 2 2 2 2 2 2 2 2 2 2 11 7 7 9 2 2 11 7 7 9 2 2 2 2 2 2 2 2 2 2 11 7 7 9 2
2 11 7 7 9 2 2 2 2 2 2 2 2 2 2 11 7 7 9 2 2 11 7 7 9 2 2 2 2 2 2 2 2 2 2 11 7 7 9 2 2 11 7 7 9 2 2 2 2 2 2 2 2 2 2 11 7 7 9 2 2 11 7 7 9 2 2 2 2 2 2 2 2 2 2 11 7 7 9 2
2 11 7 7 9 2 2 2 2 2 2 2 2 2 2 11 7 7 9 2 2 11 7 7 9 2 2 2 2 2 2 2 2 2 2 11 7 7 9 2 2 11 7 7 9 2 2 2 2 2 2 2 2 2 2 11 7 7 9 2 2 11 7 7 9 2 2 2 2 2 2 2 2 2 2 11 7 7 9 2
2 11 7 7 9 2 2 2 2 2 2 2 2 2 2 11 7 7 9 2 2 11 7 7 9 2 2 2 2 2 2 2 2 2 2 11 7 7 9 2 2 11 7 7 9 2 2 2 2 2 2 2 2 2 2 11 7 7 9 2 2 11 7 7 9 2 2 2 2 2 2 2 2 2 2 11 7 7 9 2
2 11 7 7 9 2 2 2 2 2 2 2 2 2 2 11 7 7 9 2 2 11 7 7 9 2 2 2 2 2 2 2 2 2 2 11 7 7 9 2 2 11 7 7 9 2 2 2 2 2 2 2 2 2 2 11 7 7 9 2 2 11 7 7 9 2 2 2 2 2 2 2 2 2 2 11 7 7 9 2
2 11 7 7 9 2 2 2 2 2 2 2 2 2 2 11 7 7 9 2 2 11 7 7 9 2 2 2 2 2 2 2 2 2 2 11 7 7 9 2 2 11 7 7 9 2 2 2 2 2 2 2 2 2 2 11 7 7 9 2 2 11 7 7 9 2 2 2 2 2 2 2 2 2 2 11 7 7 9 2
2 11 7 7 9 2 2 2 2 2 2 2 2 2 2 11 7 7 9 2 2 11 7 7 9 2 2 2 2 2 2 2 2 2 2 11 7 7 9 2 2 11 7 7 9 2 2 2 2 2 2 2 2 2 2 11 7 7 9 2 2 11 7 7 9 2 2 2 2 2 2 2 2 2 2 11 7 7 9 2
2 11 7 7 9 2 2 2 2 2 2 2 2 2 2 11 7 7 9 2 2 11 7 7 9 2 2 2 2 2 2 2 2 2 2 11 7 7 9 2 2 11 7 7 9 2 2 2 2 2 2 2 2 2 2 11 7 7 9 2 2 11 7 7 9 2 2 2 2 2 2 2 2 2 2 11 7 7 9 2
2 11 7 7 9 2 2 2 2 2 2 2 2 2 2 11 7 7 9 2 2 11 7 7 9 2 2 2 2 2 2 2 2 2 2 11 7 7 9 2 2 11 7 7 9 2 2 2 2 2 2 2 2 2 2 11 7 7 9 2 2 11 7 7 9 2 2 2 2 2 2 2 2 2 2 11 7 7 9 2
2 11 7 7 9 2 2 2 2 2 2 2 2 2 2 11 7 7 9 2 2 11 7 7 9 2 2 2 2 2 2 2 2 2 2 11 7 7 9 2 2 11 7 7 9 2 2 2 2 2 2 2 2 2 2 11 7 7 9 2 2 11 7 7 9 2 2 2 2 2 2 2 2 2 2 11 7 7 9 2
2 11 7 7 9 2 2 2 2 2 2 2 2 2 2 11 7 7 9 2 2 11 7 7 9 2 2 2 2 2 2 2 2 2 2 11 7 7 9 2 2 11 7 7 9 2 2 2 2 2 2 2 2 2 2 11 7 7 9 2 2 11 7 7 9 2 2 2 2 2 2 2 2 2 2 11 7 7 9 2
2 11 7 7 9 2 2 2 2 2 2 2 2 2 2 11 7 7 9 2 2 11 7 7 9 2 2 2 2 2 2 2 2 2 2 11 7 7 9 2 2 11 7 7 9 2 2 2 2 2 2 2 2 2 2 11 7 7 9 2 2 11 7 7 9 2 2 2 2 2 2 2 2 2 2 11 7 7 9 2
2 11 7 7 9 2 2 2 2 2 2 2 2 2 2 11 7 7 9 2 2 11 7 7 9 2 2 2 2 2 2 2 2 2 2 11 7 7 9 2 2 11 7 7 9 2 2 2 2 2 2 2 2 2 2 11 7 7 9 2 2 11 7 7 9 2 2 2 2 2 2 2 2 2 2 11 7 7 9 2
2 11 7 7 9 2 2 2 2 2 2 2 2 2 2 11 7 7 9 2 2 11 7 7 9 2 2 2 2 2 2 2 2 2 2 11 7 7 9 2 2 11 7 7 9 2 2 2 2 2 2 2 2 2 2 11 7 7 9 2 2 11 7 7 9 2 2 2 2 2 2 2 2 2 2 11 7 7 9 2
2 11 7 7 9 2 2 2 2 2 2 2 2 2 2 11 7 7 9 2 2 11 7 7 9 2 2 2 2 2 2 2 2 2 2 11 7 7 9 2 2 11 7 7 9 2 2 2 2 2 2 2 2 2 2 11 7 7 9 2 2 11 7 7 9 2 2 2 2 2 2 2 2 2 2 11 7 7 9 2
2 11 7 7 9 2 2 2 2 2 2 2 2 2 2 11 7 7 9 2 2 11 7 7 9 2 2 2 2 2 2 2 2 2 2 11 7 7 9 2 2 11 7 7 9 2 2 2 2 2 2 2 2 2 2 11 7 7 9 2 2 11 7 7 9 2 2 2 2 2 2 2 2 2 2 11 7 7 9 2
2 11 7 7 9 2 2 2 2 2 2 2 2 2 2 11 7 7 9 2 2 11 7 7 9 2 2 2 2 2 2 2 2 2 2 11 7 7 9 2 2 11 7 7 9 2 2 2 2 2 2 2 2 2 2 11 7 7 9 2 2 11 7 7 9 2 2 2 2 2 2 2 2 2 2 11 7 7 9 2
2 11 7 7 9 2 2 2 2 2 2 2 2 2 2 11 7 7 9 2 2 11 7 7 9 2 2 2 2 2 2 2 2 2 2 11 7 7 9 2 2 11 7 7 9 2 2 2 2 2 2 2 2 2 2 11 7 7 9 2 2 11 7 7 9 2 2 2 2 2 2 2 2 2 2 11 7 7 9 2
2 11 7 7 9 2 2 2 2 2 2 2 2 2 2 11 7 7 9 2 2 11 7 7 9 2 2 2 2 2 2 2 2 2 2 11 7 7 9 2 2 11 7 7 9 2 2 2 2 2 2 2 2 2 2 11 7 7 9 2 2 11 7 7 9 2 2 2 2 2 2 2 2 2 2 11 7 7 9 2
2 11 7 7 9 2 2 2 2 2 2 2 2 2 2 11 7 7 9 2 2 11 7 7 9 2 2 2 2 2 2 2 2 2 2 11 7 7 9 2 2 11 7 7 9 2 2 2 2 2 2 2 2 2 2 11 7 7 9 2 2 11 7 7 9 2 2 2 2 2 2 2 2 2 2 11 7 7 9 2
2 11 7 7 9 2 2 2 2 2 2 2 2 2 2 11 7 7 9 2 2 11 7 7 9 2 2 2 2 2 2 2 2 2 2 11 7 7 9 2 2 11 7 7 9 2 2 2 2 2 2 2 2 2 2 11 7 7 9 2 2 11 7 7 9 2 2 2 2 2 2 2 2 2 2 11 7 7 9 2
2 11 7 7 9 2 2 2 2 2 2 2 2 2 2 11 7 7 9 2 2 11 7 7 9 2 2 2 2 2 2 2 2 2 2 11 7 7 9 2 2 11 7 7 9 2 2 2 2 2 2 2 2 2 2 11 7 7 9 2 2 11 7 7 9 2 2 2 2 2 2 2 2 2 2 11 7 7 9 2
2 11 7 7 9 2 2 2 2 2 2 2 2 2 2 11 7 7 9 2 2 11 7 7 9 2 2 2 2 2 2 2 2 2 2 11 7 7 9 2 2 11 7 7 9 2 2 2 2 2 2 2 2 2 2 11 7 7 9 2 2 11 7 7 9 2 2 2 2 2 2 2 2 2 2 11 7 7 9 2
2 11 7 7 9 2 2 2 2 2 2 2 2 2 2 11 7 7 9 2 2 11 7 7 9 2 2 2 2 2 2 2 2 2 2 11 7 7 9 2 2 11 7 7 9 2 2 2 2 2 2 2 2 2 2 11 7 7 9 2 2 11 7 7 9 2 2 2 2 2 2 2 2 2 2 11 7 7 9 2
2 11 7 7 9 2 2 2 2 2 2 2 2 2 2 11 7 7 9 2 2 11 7 7 9 2 2 2 2 2 2 2 2 2 2 11 7 7 9 2 2 11 7 7 9 2 2 2 2 2 2 2 2 2 2 11 7 7 9 2 2 11 7 7 9 2 2 2 2 2 2 2 2 2 2 11 7 7 9 2
2 11 7 7 9 2 2 2 2 2 2 2 2 2 2 11 7 7 9 2 2 11 7 7 9 2 2 2 2 2 2 2 2 2 2 11 7 7 9 2 2 11 7 7 9 2 2 2 2 2 2 2 2 2 2 11 7 7 9 2 2 11 7 7 9 2 2 2 2 2 2 2 2 2 2 11 7 7 9 2
2 11 7 7 9 2 2 2 2 2 2 2 2 2 2 11 7 7 9 2 2 11 7 7 9 2 2 2 2 2 2 2 2 2 2 11 7 7 9 2 2 11 7 7 9 2 2 2 2 2 2 2 2 2 2 11 7 7 9 2 2 11 7 7 9 2 2 2 2 2 2 2 2 2 2 11 7 7 9 2
2 11 7 7 9 2 2 2 2 2 2 2 2 2 2 11 7 7 9 2 2 11 7 7 9 2 2 2 2 2 2 2 2 2 2 11 7 7 9 2 2 11 7 7 9 2 2 2 2 2 2 2 2 2 2 11 7 7 9 2 2 11 7 7 9 2 2 2 2 2 2 2 2 2 2 11 7 7 9 2
2 11 7 7 9 2 2 2 2 2 2 2 2 2 2 11 7 7 9 2 2 11 7 7 9 2 2 2 2 2 2 2 2 2 2 11 7 7 9 2 2 11 7 7 9 2 2 2 2 2 2 2 2 2 2 11 7 7 9 2 2 11 7 7 9 2 2 2 2 2 2 2 2 2 2 11 7 7 9 2
2 11 7 7 9 2 2 2 2 2 2 2 2 2 2 11 7 7 9 2 2 11 7 7 9 2 2 2 2 2 2 2 2 2 2 11 7 7 9 2 2 11 7 7 9 2 2 2 2 2 2 2 2 2 2 11 7 7 9 2 2 11 7 7 9 2 2 2 2 2 2 2 2 2 2 11 7 7 9 2
2 11 7 7 9 2 2 2 2 2 2 2 2 2 2 11 7 7 9 2 2 11 7 7 9 2 2 2 2 2 2 2 2 2 2 11 7 7 9 2 2 11 7 7 9 2 2 2 2 2 2 2 2 2 2 11 7 7 9 2 2 11 7 7 9 2 2 2 2 2 2 2 2 2 2 11 7 7 9 2
2 11 7 7 9 2 2 2 2 2 2 2 2 2 2 11 7 7 9 2 2 11 7 7 9 2 2 2 2 2 2 2 2 2 2 11 7 7 9 2 2 11 7 7 9 2 2 2 2 2 2 2 2 2 2 11 7 7 9 2 2 11 7 7 9 2 2 2 2 2 2 2 2 2 2 11 7 7 9 2
2 11 7 7 9 2 2 2 2 2 2 2 2 2 2 11 7 7 9 2 2 11 7 7 9 2 2 2 2 2 2 2 2 2 2 11 7 7 9 2 2 11 7 7 9 2 2 2 2 2 2 2 2 2 2 11 7 7 9 2 2 11 7 7 9 2 2 2 2 2 2 2 2 2 2 11 7 7 9 2
2 11 7 7 9 2 2 2 2 2 2 2 2 2 2 11 7 7 9 2 2 11 7 7 9 2 2 2 2 2 2 2 2 2 2 11 7 7 9 2 2 11 7 7 9 2 2 2 2 2 2 2 2 2 2 11 7 7 9 2 2 11 7 7 9 2 2 2 2 2 2 2 2 2 2 11 7 7 9 2
2 11 7 7 9 2 2 2 2 2 2 2 2 2 2 11 7 7 9 2 2 11 7 7 9 2 2 2 2 2 2 2 2 2 2 11 7 7 9 2 2 11 7 7 9 2 2 2 2 2 2 2 2 2 2 11 7 7 9 2 2 11 7 7 9 2 2 2 2 2 2 2 2 2 2 11 7 7 9 2
2 11 7 7 9 2 2 2 2 2 2 2 2 2 2 11 7 7 9 2 2 11 7 7 9 2 2 2 2 2 2 2 2 2 2 11 7 7 9 2 2 11 7 7 9 2 2 2 2 2 2 2 2 2 2 11 7 7 9 2 2 11 7 7 9 2 2 2 2 2 2 2 2 2 2 11 7 7 9 2
2 11 7 7 9 2 2 2 2 2 2 2 2 2 2 11 7 7 9 2 2 11 7 7 9 2 2 2 2 2 2 2 2 2 2 11 7 7 9 2 2 11 7 7 9 2 2 2 2 2 2 2 2 2 2 11 7 7 9 2 2 11 7 7 9 2 2 2 2 2 2 2 2 2 2 11 7 7 9 2
2 11 7 7 9 2 2 2 2 2 2 2 2 2 2 11 7 7 9 2 2 11 7 7 9 2 2 2 2 2 2 2 2 2 2 11 7 7 9 2 2 11 7 7 9 2 2 2 2 2 2 2 2 2 2 11 7 7 9 2 2 11 7 7 9 2 2 2 2 2 2 2 2 2 2 11 7 7 9 2
2 11 7 7 9 2 2 2 2 2 2 2 2 2 2 11 7 7 9 2 2 11 7 7 9 2 2 2 2 2 2 2 2 2 2 11 7 7 9 2 2 11 7 7 9 2 2 2 2 2 2 2 2 2 2 11 7 7 9 2 2 11 7 7 9 2 2 2 2 2 2 2 2 2 2 11 7 7 9 2
2 11 7 7 9 2 2 2 2 2 2 2 2 2 2 11 7 7 9 2 2 11 7 7 9 2 2 2 2 2 2 2 2 2 2 11 7 7 9 2 2 11 7 7 9 2 2 2 2 2 2 2 2 2 2 11 7 7 9 2 2 11 7 7 9 2 2 2 2 2 2 2 2 2 2 11 7 7 9 2
2 11 7 7 9 2 2 2 2 2 2 2 2 2 2 11 7 7 9 2 2 11 7 7 9 2 2 2 2 2 2 2 2 2 2 11 7 7 9 2 2 11 7 7 9 2 2 2 2 2 2 2 2 2 2 11 7 7 9 2 2 11 7 7 9 2 2 2 2 2 2 2 2 2 2 11 7 7 9 2
2 11 7 7 9 2 2 2 2 2 2 2 2 2 2 11 7 7 9 2 2 11 7 7 9 2 2 2 2 2 2 2 2 2 2 11 7 7 9 2 2 11 7 7 9 2 2 2 2 2 2 2 2 2 2 11 7 7 9 2 2 11 7 7 9 2 2 2 2 2 2 2 2 2 2 11 7 7 9 2
2 11 7 7 9 2 2 2 2 2 2 2 2 2 2 11 7 7 9 2 2 11 7 7 9 2 2 2 2 2 2 2 2 2 2 11 7 7 9 2 2 11 7 7 9 2 2 2 2 2 2 2 2 2 2 11 7 7 9 2 2 11 7 7 9 2 2 2 2 2 2 2 2 2 2 11 7 7 9 2
2 11 7 7 9 2 2 2 2 2 2 2 2 2 2 11 7 7 9 2 2 11 7 7 9 2 2 2 2 2 2 2 2 2 2 11 7 7 9 2 2 11 7 7 9 2 2 2 2 2 2 2 2 2 2 11 7 7 9 2 2 11 7 7 9 2 2 2 2 2 2 2 2 2 2 11 7 7 9 2
2 11 7 7 9 2 2 2 2 2 2 2 2 2 2 11 7 7 9 2 2 11 7 7 9 2 2 2 2 2 2 2 2 2 2 11 7 7 9 2 2 11 7 7 9 2 2 2 2 2 2 2 2 2 2 11 7 7 9 2 2 11 7 7 9 2 2 2 2 2 2 2 2 2 2 11 7 7 9 2
2 11 7 7 9 2 2 2 2 2 2 2 2 2 2 11 7 7 9 2 2 11 7 7 9 2 2 2 2 2 2 2 2 2 2 11 7 7 9 2 2 11 7 7 9 2 2 2 2 2 2 2 2 2 2 11 7 7 9 2 2 11 7 7 9 2 2 2 2 2 2 2 2 2 2 11 7 7 9 2
2 11 7 7 9 2 2 2 2 2 2 2 2 2 2 11 7 7 9 2 2 11 7 7 9 2 2 2 2 2 2 2 2 2 2 11 7 7 9 2 2 11 7 7 9 2 2 2 2 2 2 2 2 2 2 11 7 7 9 2 2 11 7 7 9 2 2 2 2 2 2 2 2 2 2 11 7 7 9 2
2 11 7 7 9 2 2 2 2 2 2 2 2 2 2 11 7 7 9 2 2 11 7 7 9 2 2 2 2 2 2 2 2 2 2 11 7 7 9 2 2 11 7 7 9 2 2 2 2 2 2 2 2 2 2 11 7 7 9 2 2 11 7 7 9 2 2 2 2 2 2 2 2 2 2 11 7 7 9 2
2 11 7 7 9 2 2 2 2 2 2 2 2 2 2 11 7 7 9 2 2 11 7 7 9 2 2 2 2 2 2 2 2 2 2 11 7 7 9 2 2 11 7 7 9 2 2 2 2 2 2 2 2 2 2 11 7 7 9 2 2 11 7 7 9 2 2 2 2 2 2 2 2 2 2 11 7 7 9 2
2 11 7 7 9 2 2 2 2 2 2 2 2 2 2 11 7 7 9 2 2 11 7 7 9 2 2 2 2 2 2 2 2 2 2 11 7 7 9 2 2 11 7 7 9 2 2 2 2 2 2 2 2 2 2 11 7 7 9 2 2 11 7 7 9 2 2 2 2 2 2 2 2 2 2 11 7 7 9 2
2 11 7 7 9 2 2 2 2 2 2 2 2 2 2 11 7 7 9 2 2 11 7 7 9 2 2 2 2 2 2 2 2 2 2 11 7 7 9 2 2 11 7 7 9 2 2 2 2 2 2 2 2 2 2 11 7 7 9 2 2 11 7 7 9 2 2 2 2 2 2 2 2 2 2 11 7 7 9 2
2 11 7 7 9 2 2 2 2 2 2 2 2 2 2 11 7 7 9 2 2 11 7 7 9 2 2 2 2 2 2 2 2 2 2 11 7 7 9 2 2 11 7 7 9 2 2 2 2 2 2 2 2 2 2 11 7 7 9 2 2 11 7 7 9 2 2 2 2 2 2 2 2 2 2 11 7 7 9 2
2 11 7 7 9 2 2 2 2 2 2 2 2 2 2 11 7 7 9 2 2 11 7 7 9 2 2 2 2 2 2 2 2 2 2 11 7 7 9 2 2 11 7 7 9 2 2 2 2 2 2 2 2 2 2 11 7 7 9 2 2 11 7 7 9 2 2 2 2 2 2 2 2 2 2 11 7 7 9 2
2 11 7 7 9 2 2 2 2 2 2 2 2 2 2 11 7 7 9 2 2 11 7 7 9 2 2 2 2 2 2 2 2 2 2 11 7 7 9 2 2 11 7 7 9 2 2 2 2 2 2 2 2 2 2 11 7 7 9 2 2 11 7 7 9 2 2 2 2 2 2 2 2 2 2 11 7 7 9 2
2 11 7 7 9 2 2 2 2 2 2 2 2 2 2 11 7 7 9 2 2 11 7 7 9 2 2 2 2 2 2 2 2 2 2 11 7 7 9 2 2 11 7 7 9 2 2 2 2 2 2 2 2 2 2 11 7 7 9 2 2 11 7 7 9 2 2 2 2 2 2 2 2 2 2 11 7 7 9 2
2 11 7 7 9 2 2 2 2 2 2 2 2 2 2 11 7 7 9 2 2 11 7 7 9 2 2 2 2 2 2 2 2 2 2 11 7 7 9 2 2 11 7 7 9 2 2 2 2 2 2 2 2 2 2 11 7 7 9 2 2 11 7 7 9 2 2 2 2 2 2 2 2 2 2 11 7 7 9 2
2 11 7 7 9 2 2 2 2 2 2 2 2 2 2 11 7 7 9 2 2 11 7 7 9 2 2 2 2 2 2 2 2 2 2 11 7 7 9 2 2 11 7 7 9 2 2 2 2 2 2 2 2 2 2 11 7 7 9 2 2 11 7 7 9 2 2 2 2 2 2 2 2 2 2 11 7 7 9 2
2 11 7 7 9 2 2 2 2 2 2 2 2 2 2 11 7 7 9 2 2 11 7 7 9 2 2 2 2 2 2 2 2 2 2 11 7 7 9 2 2 11 7 7 9 2 2 2 2 2 2 2 2 2 2 11 7 7 9 2 2 11 7 7 9 2 2 2 2 2 2 2 2 2 2 11 7 7 9 2
2 11 7 7 9 2 2 2 2 2 2 2 2 2 2 11 7 7 9 2 2 11 7 7 9 2 2 2 2 2 2 2 2 2 2 11 7 7 9 2 2 11 7 7 9 2 2 2 2 2 2 2 2 2 2 11 7 7 9 2 2 11 7 7 9 2 2 2 2 2 2 2 2 2 2 11 7 7 9 2
2 11 7 7 9 2 2 2 2 2 2 2 2 2 2 11 7 7 9 2 2 11 7 7 9 2 2 2 2 2 2 2 2 2 2 11 7 7 9 2 2 11 7 7 9 2 2 2 2 2 2 2 2 2 2 11 7 7 9 2 2 11 7 7 9 2 2 2 2 2 2 2 2 2 2 11 7 7 9 2
2 11 7 7 9 2 2 2 2 2 2 2 2 2 2 11 7 7 9 2 2 11 7 7 9 2 2 2 2 2 2 2 2 2 2 11 7 7 9 2 2 11 7 7 9 2 2 2 2 2 2 2 2 2 2 11 7 7 9 2 2 11 7 7 9 2 2 2 2 2 2 2 2 2 2 11 7 7 9 2